R 1080 1080 
C 0, 0, 100
F 0, 100, 0

NO ./pics/colorstone.xpm
SO ./pics/greystone.xpm
WE ./pics/redbrick.xpm
EA ./pics/wood.xpm
S ./pics/pillar.xpm

1111111111111111111111111
1000000000000000000000111
1000111111111111100000111
1000100000000000000000111
1000100000000000000000001
1000101000001110000000001
1000100000011100000000001
1000100000111000000000001
1000100001110000000000001
1000100000000000000000001
1000100000000000000000001
1000100000000000001000001
1000100010101000010100001
1000000101010100001000001
1000000000000000000000001
1000000000000000000000001
1000000111111111100000001
10000001        100000001
10100001        100111001
10000001        100001001
10100001        101101001
10E00001        100001101
11111111        111111111