R 1920 1080 
C 10, 40, 201
F 1, 100, 17

NO ./textures/no.txt
SO ./textures/so.txt
WE ./textures/we.txt
EA ./textures/ea.txt
S ./textures/s.txt

11111111
10000111
10000001
10000001
10000001
10000001
10000N01
11111111