R 1000 1000
C 0, 0, 50
F 0, 50, 0

NO ./pics/colorstone.xpm
SO ./pics/wood.xpm
WE ./pics/redbrick.xpm
EA ./pics/greystone.xpm
S ./pics/pillar.xpm

11111111111111111111111111111111111
10000100100100100010010010000000001
10000020000000000000000000000000001
10000002020200000000000000000000001
10000000202020002000200020002000001
11111100000000000000000000020000001
11111100000000000000000012000000001
10000002020202020000000120000000001
10000000000000000000001200000000001
10000002020202020000012000000000001
10000000000000000000012000000000001
10000100000110000000001200000000001
10100000001111000000000120000200001
10100000000110000000000012000000001
10100000000000000000000000000000001
10000000000000000000000000000000001
10000020000000000000000000000000001
10000000000000001000002000000000001
10000000000000000000000100000000001
10001000001000000000000210000002001
10001000000000000020000120000200001
10001000000000000000000210000002001
10001020000000000000000120000200001
10001000000000000000000210000002001
10N01000000010000000000100000200001
10001001000000001111102000000002001
10001020000000001000100000000200001
10001111111100001000000000000002001
10000000000000001000000000000200001
11111111111111111111111111111111111