R 1920 1080 
C 10, 40, 201
F 1, 100, 17

NO ./textures/no.txt
SO ./textures/so.txt
WE ./textures/we.txt
EA ./textures/ea.txt
S ./textures/s.txt

 1111111111111111111
 11000011    1  111111
 10000001    1  111111111
 1000000111111 111
 100N000000001  1111111
 1111111111111  111
 11111111111111111111111111
 1111   1000111
    11111111101111111111111
    11111111111111  11
    1111       1111
    1111        11