R 1920 1080 
C 10, 40, 201
F 1, 100, 17

NO ./textures/no.txt
SO ./textures/so.txt
WE ./textures/we.txt
EA ./textures/ea.txt
S ./textures/s.txt

 1111111111111111111111
 1101010010101010101111
 1000000000000000000111
 1100000000000000000011
 1000000000000000000001
 1100000000000000000011
 1000000000000000000001
 1100000000010000000011
 1000000000111000000001
 1100000000000000000011
 10000000000N0000000001
 1100000000000000000011
 1000000000000000000001
 1101000000000000000011
 1000000000000000100001
 1100000000000000000011
 1001010010010001001001
 1111111111111111111111