R 1000000000000 10000
C 1000, 40, 201

F 255, 22, 1
NO ./textures/no.txt
SO ./textures/so.txt
WE ./textures/we.txt
EA ./textures/ea.txt
S ./textures/s.txt

1111111111
1111111111
1000000001
10000000011111111111
10000N000111111111
1111111111
 
11111111111111111
100000000111111
11111111111
 
1111111111
10000000011111111
1000000001
111111111111111111