R 1 1000

C 255, 208, 201
F 255, 22, 1
NO ./textures/no.txt
SO ./textures/so.txt
WE ./textures/we.txt
EA ./textures/ea.txt
S ./textures/s.txt

1111111111
1111111111
1000000001
10000000011111111111
100000000111111111
1111011111
11110111111111111
100000000111111
1000000001
100000N001
10000000011111111
1000000001
1111111111
111111111