R 1920 1000

F 194, 167, 168
C 162, 100, 201

NO ./no.txt
SO ./so.txt
WE ./we.txt
EA ./ea.txt
S ./s.txt

1111111111
1000000001
1000000001
1000000001
1000000001
1000000001
1000000001
1000000001
1000000001
1111111111
