R 1920 1080 
C 10, 40, 201
F 1, 100, 17

NO ./pics/colorstone.xpm
SO ./pics/greystone.xpm
WE ./pics/redbrick.xpm
EA ./pics/wood.xpm
S ./textures/s.txt

1111111111111111111111111
1000000000000000000000111
1000100000000000000000111
1000100000000000000000111
1000100000000000000000001
1000101000001110000000001
1000100000011100000000001
1000100000111000000000001
1000100001110000000000001
1000100000000000000000001
1000100000000000000000001
1000100000000000001000001
1000100010101000010100001
1000000101010100001000001
1000000000000000000000001
100000000000000000N000001
1000000111111111111111111
10000001
10010001
100000011
10100001
10000001
11111111