R 1080 720 
C 100, 40, 201
F 100, 1, 17

NO ./textures/no.txt
SO ./textures/so.txt
WE ./textures/we.txt
EA ./textures/ea.txt
S ./textures/s.txt
 
 1111111111111111111
 11000001    1  111
 10000001    1  111
 1000000111111  101
 1000W10000001  111
 1111111111111  111
 1111111111111111111
 1111   10001
    111111111
    1111111111  11
    1111       1111
    1111        11